453,364,356,357,352,353,354,355,356,357,352,353,354,355,356,357,352,353,354,355,356,357,352,353,354,355,356,357,352,353,354,355,356,357,352,353,354,355,356,357,352,353,354,355,356,357,352,353,354,355,356,357,352,353,354,355,356,357,352,353,354,355,356,357,352,353,354,355,356,357,352,353,354,355,356,357,352,353,354,355,356,357,352,353,354,355,356,357,352,353,354,355,356,357,352,353
485,387,388,389,384,385,386,387,388,389,384,385,386,387,388,389,384,385,386,387,388,389,384,385,386,387,388,389,384,385,386,387,388,389,384,385,386,387,388,389,384,385,386,387,388,389,384,385,386,387,388,389,384,385,386,387,388,389,384,385,386,387,388,389,384,385,386,387,388,389,384,385,386,387,388,389,384,385,386,387,388,389,384,385,386,387,388,389,384,385,386,387,388,389,384,385
453,419,420,421,416,417,418,419,420,421,416,417,418,419,420,421,416,417,418,419,420,421,416,417,418,419,420,421,416,417,418,419,420,421,416,417,418,419,420,421,416,417,418,419,420,421,416,417,418,419,420,421,416,417,418,419,420,421,416,417,418,419,420,421,416,417,418,419,420,421,416,417,418,419,420,421,416,417,418,419,420,421,416,417,418,419,420,421,416,417,418,419,420,421,416,417
485,359,360,361,360,361,362,359,360,361,360,361,362,359,360,361,360,361,362,359,360,361,360,361,362,359,360,361,360,361,362,359,360,361,360,361,362,359,360,361,360,361,362,359,360,361,360,361,362,359,360,361,360,361,362,359,360,361,360,361,362,359,360,361,360,361,362,359,360,361,360,361,362,359,360,361,360,361,362,359,360,361,360,361,362,359,360,361,360,361,362,359,360,361,360,361
453,391,392,392,393,393,394,391,392,392,393,393,394,391,392,392,393,393,394,391,392,392,393,393,394,391,392,392,393,393,394,391,392,392,393,393,394,391,392,392,393,393,394,391,392,392,393,393,394,391,392,392,393,393,394,391,392,392,393,393,394,391,392,392,393,393,394,391,392,392,393,393,394,391,392,392,393,393,394,391,392,392,393,393,394,391,392,392,393,393,394,391,392,392,393,393
485,396,356,356,356,356,354,355,356,356,356,356,354,355,356,356,356,356,354,355,356,356,356,356,354,355,356,356,356,356,354,355,356,356,356,356,354,355,356,356,356,356,354,355,356,356,356,356,354,355,356,356,356,356,354,355,356,356,356,356,354,355,356,356,356,356,354,355,356,356,356,356,354,355,356,356,356,356,354,355,356,356,356,356,354,355,356,356,356,356,354,355,356,356,356,356
453,289,288,289,288,289,128,129,288,289,288,289,128,129,288,289,288,289,128,129,288,289,288,289,128,129,288,289,288,289,128,129,288,289,288,289,128,129,288,289,288,289,128,129,288,289,288,289,128,129,288,289,288,289,128,129,288,289,288,289,128,129,288,289,288,289,128,129,288,289,288,289,128,129,288,289,288,289,128,129,288,289,288,289,128,129,288,289,288,289,128,129,288,289,288,289
485,257,256,257,256,257,128,129,256,257,256,257,128,129,256,257,256,257,128,129,256,257,256,257,128,129,256,257,256,257,128,129,256,257,256,257,128,129,256,257,256,257,128,129,256,257,256,257,128,129,256,257,256,257,128,129,256,257,256,257,128,129,256,257,256,257,128,129,256,257,256,257,128,129,256,257,256,257,128,129,256,257,256,257,128,129,256,257,256,257,128,129,256,257,256,257
453,289,288,289,288,289,128,129,288,289,288,289,128,129,288,289,288,289,128,129,288,289,288,289,128,129,288,289,288,289,128,129,288,289,288,289,128,129,288,289,288,289,128,129,288,289,288,289,128,129,288,289,288,289,128,129,288,289,288,289,128,129,288,289,288,289,128,129,288,289,288,289,128,129,288,289,288,289,128,129,288,289,288,289,128,129,288,289,288,289,128,129,288,289,288,289
485,257,256,257,256,257,11,12,256,257,256,257,11,12,256,257,256,257,11,12,256,257,256,257,11,12,256,257,256,257,11,12,256,257,256,257,11,12,256,257,256,257,11,12,256,257,256,257,11,12,256,257,256,257,11,12,256,257,256,257,11,12,256,257,256,257,11,12,256,257,256,257,11,12,256,257,256,257,11,12,256,257,256,257,11,12,256,257,256,257,11,12,256,257,256,257
453,289,288,289,288,289,43,44,288,289,288,289,43,44,288,289,288,289,43,44,288,289,288,289,43,44,288,289,288,289,43,44,288,289,288,289,43,44,288,289,288,289,43,44,288,289,288,289,43,44,288,289,288,289,43,44,288,289,288,289,43,44,288,289,288,289,43,44,288,289,288,289,43,44,288,289,288,289,43,44,288,289,288,289,43,44,288,289,288,289,43,44,288,289,288,289
485,257,256,257,256,257,75,76,256,257,256,257,75,76,256,257,256,257,75,76,256,257,256,257,75,76,256,257,256,257,75,76,256,257,256,257,75,76,256,257,256,257,75,76,256,257,256,257,75,76,256,257,256,257,75,76,256,257,256,257,75,76,256,257,256,257,75,76,256,257,256,257,75,76,256,257,256,257,75,76,256,257,256,257,75,76,256,257,256,257,75,76,256,257,256,257
453,289,288,289,288,289,107,108,288,289,288,289,107,108,288,289,288,289,107,108,288,289,288,289,107,108,288,289,288,289,107,108,288,289,288,289,107,108,288,289,288,289,107,108,288,289,288,289,107,108,288,289,288,289,107,108,288,289,288,289,107,108,288,289,288,289,107,108,288,289,288,289,107,108,288,289,288,289,107,108,288,289,288,289,107,108,288,289,288,289,107,108,288,289,288,289
485,257,256,257,256,257,160,161,256,257,256,257,160,161,256,257,256,257,160,161,256,257,256,257,160,161,256,257,256,257,160,161,256,257,256,257,160,161,256,257,256,257,160,161,256,257,256,257,160,161,256,257,256,257,160,161,256,257,256,257,160,161,256,257,256,257,160,161,256,257,256,257,160,161,256,257,256,257,160,161,256,257,256,257,160,161,256,257,256,257,160,161,256,257,256,257
453,289,288,289,288,289,192,193,288,289,288,289,192,193,288,289,288,289,192,193,288,289,288,289,192,193,288,289,288,289,192,193,288,289,288,289,192,193,288,289,288,289,192,193,288,289,288,289,192,193,288,289,288,289,192,193,288,289,288,289,192,193,288,289,288,289,192,193,288,289,288,289,192,193,288,289,288,289,192,193,288,289,288,289,192,193,288,289,288,289,192,193,288,289,288,289
485,364,356,357,352,353,354,355,356,357,352,353,354,355,356,357,352,353,354,355,356,357,352,353,354,355,356,321,320,321,354,355,356,357,352,353,354,355,356,357,352,353,354,355,356,321,320,321,320,321,320,357,352,353,354,355,356,357,352,353,354,355,356,357,352,353,354,355,356,321,320,321,320,321,320,321,320,353,354,355,356,357,352,353,354,355,356,357,352,353,354,355,356,357,352,353
453,387,388,389,384,385,386,387,388,389,384,385,386,387,388,389,384,385,386,387,388,389,384,385,386,387,388,422,422,422,386,387,388,389,384,385,386,387,388,389,384,385,386,387,388,422,422,422,422,422,422,389,384,385,386,387,388,389,384,385,386,387,388,389,384,385,386,387,388,422,422,422,422,422,422,422,422,385,386,387,388,389,384,385,386,387,388,389,384,385,386,387,388,389,384,385
485,419,420,421,416,417,418,419,420,421,416,417,418,419,420,421,416,417,418,419,420,421,416,417,418,419,420,422,422,422,421,419,420,421,416,417,418,419,420,421,416,417,418,419,420,422,422,422,422,422,422,421,416,417,418,419,420,421,416,417,418,419,420,421,416,417,418,419,420,422,422,422,422,422,422,422,422,417,418,419,420,421,416,417,418,419,420,421,416,417,418,419,420,421,416,417
