364,356,357,352,353,354,355,356,357,352,353,354,355,356,357,352,353,354,355,356,357,352,353,354,355,356,357,352,353,354,355,356,357,352,353,354,355,356,357,352,353
387,388,389,384,385,386,387,388,389,384,385,386,387,388,389,384,385,386,387,388,389,384,385,386,387,388,389,384,385,386,387,388,389,384,385,386,387,388,389,384,385
419,420,421,416,417,418,419,420,421,416,417,418,419,420,421,416,417,418,419,420,421,416,417,418,419,420,421,416,417,418,419,420,421,416,417,418,419,420,421,416,417
359,360,361,360,361,362,359,360,361,360,361,362,359,360,361,360,361,362,359,360,361,360,361,362,359,360,361,360,361,362,359,360,361,360,361,362,359,360,361,360,361
391,392,392,393,393,394,391,392,392,393,393,394,391,392,392,393,393,394,391,392,392,393,393,394,391,392,392,393,393,394,391,392,392,393,393,394,391,392,392,393,393
356,356,356,356,356,356,356,356,356,356,356,356,356,356,356,356,356,356,356,356,356,356,353,356,356,356,356,356,356,356,356,356,356,356,356,356,356,356,356,356,356
517,166,166,256,257,128,129,256,257,256,257,128,129,256,257,256,257,128,129,256,257,256,257,128,129,256,257,256,257,128,129,256,257,256,257,128,129,256,257,256,257
517,166,166,288,289,128,129,288,289,288,289,128,129,288,289,288,289,128,129,288,289,288,289,128,129,288,289,288,289,128,129,288,289,288,289,128,129,288,289,288,289
517,166,166,256,257,128,129,256,257,256,257,128,129,256,257,256,257,128,129,256,257,256,257,128,129,256,257,256,257,128,129,256,257,256,257,128,129,256,257,256,257
517,166,166,288,289,128,129,288,289,288,289,128,129,288,289,288,289,128,129,288,289,288,289,128,129,288,289,288,289,128,129,288,289,288,289,128,129,288,289,288,225
517,166,166,256,257,11,12,256,257,356,356,356,356,356,356,356,356,356,356,356,356,356,356,356,12,256,257,256,257,11,12,256,257,256,257,11,12,256,257,256,257
517,166,166,288,289,43,44,288,289,288,289,43,44,288,289,288,289,43,44,288,289,288,289,43,44,288,289,288,289,43,44,288,289,288,289,43,44,288,289,288,289
517,166,166,256,257,75,76,256,257,256,257,75,76,256,257,256,257,75,76,256,257,256,257,75,76,256,257,256,257,75,76,256,257,256,257,75,76,256,257,256,257
364,356,357,352,353,354,108,288,289,288,289,107,108,288,289,288,289,107,108,288,289,288,289,107,108,288,289,288,289,107,108,288,289,288,289,107,108,288,289,288,289
387,388,389,384,385,386,161,256,257,256,257,160,161,256,257,256,257,160,161,256,257,256,257,160,161,256,257,256,257,160,161,256,257,256,257,160,161,256,257,256,257
419,420,421,416,417,418,193,288,289,288,289,192,193,288,289,288,289,192,193,288,289,288,289,192,193,288,289,288,289,192,193,288,289,288,289,192,193,288,289,288,289
359,360,361,360,361,362,355,356,357,615,353,354,355,356,357,352,353,354,355,356,357,352,353,354,355,356,357,352,353,354,355,356,357,352,353,354,355,356,357,352,353
391,392,392,393,393,394,387,388,389,384,385,386,387,388,389,384,385,386,387,388,389,384,385,386,387,388,389,384,385,386,387,388,389,384,385,386,387,388,389,384,385
387,388,389,384,385,386,419,420,421,416,417,418,419,420,421,416,417,418,419,420,421,416,417,418,419,420,421,416,417,418,419,420,421,416,417,418,419,420,421,416,417
356,356,356,356,356,356,356,356,356,356,356,356,356,356,356,356,356,356,356,356,356,356,356,356,356,356,356,356,356,356,356,356,356,356,356,356,356,356,356,356,356
