364,356,357,352,353,354,355,356,357,352,353,354,355,356,357,352,353,354,355,356,357,352,353,354,355,356,357,352,353,354,355,356,357,352,353,354,355,356,357,352,353
387,388,389,384,385,386,387,388,389,384,385,386,387,388,389,384,385,386,387,388,389,384,385,386,387,388,389,384,385,386,387,388,389,384,385,386,387,388,389,384,385
419,420,421,416,417,418,419,420,421,416,417,418,419,420,421,416,417,418,419,420,421,416,417,418,419,420,421,416,417,418,419,420,421,416,417,418,419,420,421,416,417
359,360,361,360,361,362,359,360,361,360,361,362,359,360,361,360,361,362,359,360,361,360,361,362,359,360,361,360,361,362,359,360,361,360,361,362,359,360,361,360,361
391,392,392,392,393,394,391,392,392,392,393,394,391,392,392,392,393,394,391,392,392,392,393,394,391,392,392,392,393,394,391,392,392,392,393,394,391,392,392,392,393
364,356,357,352,353,354,355,356,356,356,356,356,356,356,356,356,356,356,356,356,356,356,356,356,356,356,356,356,356,354,355,356,357,352,353,354,355,356,357,352,353
387,388,389,384,385,386,453,288,289,288,289,128,129,288,289,288,289,128,129,288,289,288,289,128,129,288,289,288,289,453,387,388,389,384,385,386,387,388,389,384,385
419,420,421,416,417,418,485,256,257,256,257,128,129,256,257,256,257,128,129,256,257,256,257,128,129,256,257,256,257,485,419,420,421,416,417,418,419,420,421,416,417
359,360,361,360,361,362,453,288,289,288,289,128,129,288,289,288,289,128,129,288,289,6,7,8,9,288,289,288,289,453,359,360,361,360,361,362,359,360,361,360,361
391,392,392,392,393,394,485,256,257,256,257,128,129,256,257,256,257,128,129,256,257,38,39,40,41,256,257,256,257,485,391,392,392,392,393,394,391,392,392,392,393
356,356,356,356,356,356,396,288,289,288,289,128,129,288,289,288,289,128,129,288,289,70,71,72,73,288,289,288,289,395,356,356,356,356,356,356,356,356,356,356,356
257,256,257,256,257,11,12,256,257,256,257,11,12,256,257,256,257,11,12,256,257,102,103,104,105,256,257,256,257,11,12,256,257,256,257,11,12,256,257,256,257
289,288,289,288,289,43,44,288,289,288,289,43,44,288,289,224,289,43,44,288,289,134,135,136,137,288,289,288,289,43,44,288,289,288,289,43,44,288,289,288,289
257,256,257,256,257,75,76,256,257,256,423,424,423,424,423,424,257,75,76,256,257,256,257,75,76,256,257,256,257,75,76,256,257,256,257,75,76,256,257,256,257
289,288,289,288,289,107,108,288,289,288,289,107,108,288,289,288,289,107,108,288,289,288,289,107,108,288,289,288,289,107,108,288,289,288,289,107,108,288,289,288,289
257,256,257,256,257,160,161,256,257,256,257,160,161,256,257,256,257,160,161,256,257,256,257,160,161,256,257,256,257,160,161,256,257,256,257,160,161,256,257,256,257
289,288,289,288,289,192,193,288,289,288,289,192,193,288,289,288,289,192,193,288,289,288,289,192,193,288,289,288,289,192,193,288,289,288,289,192,193,288,289,288,289
364,356,357,352,353,354,355,356,357,352,353,354,355,356,357,352,353,354,355,356,357,352,353,354,355,356,357,352,353,354,355,356,357,352,353,354,355,356,357,352,353
387,388,389,384,385,386,387,388,389,384,385,386,387,388,389,384,385,386,387,388,389,384,385,386,387,388,389,384,385,386,387,388,389,384,385,386,387,388,389,384,385
419,420,421,416,417,418,419,420,421,416,417,418,419,420,421,416,417,418,419,420,421,416,417,418,419,420,421,416,417,418,419,420,421,416,417,418,419,420,421,416,417
356,356,356,356,356,356,356,356,356,356,356,356,356,356,356,356,356,356,356,356,356,356,356,356,356,356,356,356,356,356,356,356,356,356,356,356,356,356,356,356,356
